NO ./texture/backroom.xpm
SO ./texture/backroom.xpm
WE ./texture/backroom.xpm
EA ./texture/backroom.xpm

F 249,246,173
C 249,246,173

1111111111111111111111111
1000000000110000000000001
1011000001110000000000001
101100100000000000000000111111111
111111111011000000000000000000001
100000000011000000011111111111111
10110000000000000000000000001
11110111111111000000000000001
11111111111110000100011111111
10000000000000000000000000001
10000000100000000000000000001111111111111111
10000000000000000N00000001000000000000000001
10000000000000000000000000001111111111111111
1111111111111110000111111111111
1000000000100000000000100000011
1000000000000000000000100000001
1111111111111111110000100000001
1000000000000001111000000000001
1000000000000000000000000000001
1111111111111111111111111111111
