NO ./texture/backroom.xpm
SO ./texture/backroom.xpm




WE ./texture/backroom.xpm

EA                                                                                               ./texture/backroom.xpm


F 249,246,173



C 249,246,173


1111111111111111111111111
10000000000N0000000000001
1000000000000000000000001
11111111111D1111111111111
1000000000000000000000001
1111111111111111111111111
