NO ./texture/murcool.xpm
SO ./texture/murcool.xpm
WE ./texture/murcool.xpm
EA ./texture/murcool.xpm

F 150,50,0
C 0,0,220

1111111111111111111111111
1000000000110000000000001
1011000001110000000000001
101100100000000100000000111111111
111111111011000000000000000000001
100000000011000000011111111111111
10110000000000000000000000001
11110111111111000000000000001
11111111111111110001111111111
10000000010000000000000000001
10000000010000000000000000001
10000000000000000N00000000001
10000000000000000000000000001
1111111111111110000111111111111
1000000000000000000000000000011
1000000000000000000000000000001
1111111111111111110000000000001
1000000000000000000000000000001
1111111111111111111111111111111
