NO ./path_to_the_north_texture
SO ./path_to_the_south_texture
WE ./path_to_the_west_texture
EA ./path_to_the_east_texture

F 020,50,100
C 0,0,220

1111111111111111111111111
1000000000110000000000001
1011000001110000000000001
101100100000000000000000111111111
111111111011000001110000000000001
100000000011000001111111111111111
10110000000000000000000000001
11110111111111000000000000001
11111111111111110001111111111
10000000000000000000000000001
10000000000000000000000000001
10000000000000000N00000000001
10000000000000000000000000001
11111111111111111111111111111
